11111111
100P0001
101101C1
1C01E101
11111111