11111111111111
1P1000100010E1
10101010101011
10101010101011
10101010101011
10101010101011
10101010101011
10101010101011
10101010101011
10101010101011
101C1010101011
1000100C10C011
11111111111111