11111111111111111111111111111111
10000000000000011000000000000001
10000001000100011000000100010001
1000PCE1001110011000000100101001
10000000101000011000000010100001
10000000100000000000000010000001
10000000100000011000000010000001
10000000100000011000000010000001
10000000100000011000000010000001
10000000100000011000000010000001
10000000100000011000000010000001
10000000100000011000000010000001
11111111111111111111111111111111