11111111111111111111111111111111
10000000000000000000000000000001
1000000000000000000000000000C001
10000000000000000000000000000001
100000000111110C0000000000000001
10000000010C00000000000000000001
10000000010000000000000000000001
10000000010001000000000000000001
100000000C000100000C000000000001
10000000000000000000000000000001
100000000000000PC100000000000001
10000000000001000000000001000001
10000000000001000000000001000001
1000000000000000000C00000100E001
1000000000C000000000000001000001
11111111111111111111111111111111