11111111
100P0001
101101C1
1C01E1C1
11111111