1111111111111111
1C00000000C00001
100000010001C001
1000PC01001E10C1
1000000010100001
1000000010000C01
1111111111111111